Protein,Ispred_residues,Dock_residues,Residue_difference,Missing_residues,Protein_Status
2AJF.E,174,166,8,8,
3BIW.A,533,441,92,92,
1PVH.B,169,165,4,4,
1DFJ.E,124,124,0,0,
2HLE.B,133,132,1,1,
1ML0.A,371,345,26,26,
1KXP.D,438,420,18,18,
1E4K.C,172,172,0,0,
3R9A.B,289,250,39,39,
1EXB.E,91,91,0,0,
4G6J.H,430,401,29,29,
7CEI.A,87,87,0,0,
1JPS.H,426,403,23,23,
4M76.B,179,171,8,8,
3HI6.X,426,355,71,71,
1AK4.A,165,162,3,3,
3HMX.L,431,403,28,28,
1KXP.A,349,322,27,27,
4M76.A,296,257,39,39,
1ZHH.A,344,321,23,23,
7CEI.B,127,126,1,1,
3EO1.A,431,409,22,22,
1FLE.E,229,212,17,17,
1AY7.A,96,95,1,1,
3SZK.E,123,123,0,0,
3V6Z.A,440,376,64,64,
1GHQ.A,307,262,45,45,
1QA9.B,95,95,0,0,
1MLC.A,432,405,27,27,
1VFB.A,223,210,13,13,
1QA9.A,102,102,0,0,
4JCV.E,214,213,1,1,
1BGX.H,415,305,110,110,
1AY7.B,89,88,1,1,
3SZK.F,141,138,3,3,
1KTZ.A,82,82,0,0,
1OFU.A,307,282,25,25,
1FC2.D,206,206,0,1,Extra Terminus Residue
1XQS.A,264,252,12,12,
3S9D.B,180,178,2,2,
1KLU.D,230,215,15,15,
2B4J.C,82,82,0,0,
3RVW.C,429,403,26,26,
2HQS.A,412,254,158,158,
1F34.A,325,301,24,24,
1DFJ.I,456,434,22,22,
2A5T.A,271,254,17,17,
1GXD.A,624,580,44,44,
3BX7.C,120,120,0,0,
1T6B.Y,170,161,9,9,
2B42.A,364,335,29,29,
1T6B.X,676,635,41,41,
1E6J.H,429,406,23,23,
1JIW.P,470,431,39,39,
3VLB.A,404,371,33,33,
3BX7.A,173,173,0,0,
3VLB.B,218,211,7,7,
1GXD.C,192,187,5,5,
1MQ8.B,177,164,13,13,
2B42.B,184,178,6,6,
2SIC.E,275,245,30,30,
1AVX.A,220,206,14,14,
1WEJ.H,437,411,26,26,
3MXW.L,426,403,23,23,
2A5T.B,276,262,14,14,
2C0L.A,292,281,11,11,
1KAC.B,124,123,1,1,
1IRA.X,145,143,2,2,
1ZHI.A,195,191,4,4,
3DAW.A,372,337,35,35,
1FFW.A,128,124,4,4,
1ACB.I,63,63,0,0,
3EOA.L,429,386,43,43,
1DQJ.A,424,386,38,38,
2VDB.A,574,531,43,43,
2VIS.A,431,389,42,42,
1S1Q.A,137,136,1,1,
1DE4.E,99,97,2,2,
2O3B.A,241,226,15,15,
1KAC.A,185,181,4,4,
1FFW.B,68,68,0,0,
3DAW.B,140,136,4,4,
1ZHI.B,125,125,0,0,
1TMQ.A,470,416,54,54,
3F1P.A,114,111,3,3,
1US7.A,206,195,11,12,Extra Terminus Residue
3AAA.C,117,116,1,1,
4G6M.H,433,398,35,35,
1ACB.E,241,222,19,19,
1JIW.I,105,105,0,0,
2J0T.D,124,123,1,1,
2HRK.B,121,121,0,0,
1AHW.A,428,404,24,24,
3G6D.L,433,393,40,40,
1TMQ.B,117,116,1,1,
1US7.B,193,190,3,4,Extra Terminus Residue
3F1P.B,111,109,2,2,
2BTF.A,373,337,36,36,
2SIC.I,107,107,0,0,
2FD6.H,420,380,40,40,
2VXT.H,203,391,-188,15,Extra Docking Chain
4FQI.H,207,391,-184,11,Extra Docking Chain
3L5W.L,436,394,42,42,
2BTF.P,139,134,5,5,
2CFH.C,149,146,3,4,Extra Terminus Residue
2W9E.H,427,392,35,35,
4DN4.L,427,394,33,33,
2J0T.A,161,157,4,4,